//0 tile
//1 hole
//2 digger1
//3 spawner
//4 goldbag
//5 gem
// only for multiplayer
//6 digger2
//7 nobbin



Level 1
700040000011113
100550050010400
140550050010000
100554054010555
100550050010555
110550050010555
010000404010000
011110000010000
500010000010005
550016121110055

Level 2
711111004040013
055001000000010
055001055555010
455401055555010
555501000000010
555501040011110
055001055010000
044001555510550
500006055010550
550001121110000

Level 3
711114040411113
550010505010440
500010505010550
044010505015555
555510505015555
555511111110550
055005010500550
055005010500000
500005060500005
550005020500055